ID: 30728
Title: HEX(LPAD) behavior doesn't match with both 5.7 and 8.0 
Description:
## Bug Report

Please answer these questions before submitting your issue. Thanks!

### 1. Minimal reproduce step (Required)

<!-- a step by step guide for reproducing the bug. -->
```sql
CREATE TABLE t1(c1 VARCHAR(10));
INSERT INTO t1 VALUES ('Alaska');
SELECT HEX(LPAD('', 42, REPLACE(COMPRESS(42),c1,''))) FROM t1;
SELECT HEX(LPAD('', 42, SUBSTRING_INDEX(COMPRESS(42),c1,1))) FROM t1;
SELECT HEX(LPAD('', 42, TRIM(x'ffff' FROM c1))) FROM t1;
SELECT LPAD('', 42, REPLACE(c1, 'las', x'ff')) FROM t1;
SELECT HEX(SUBSTRING_INDEX(_utf8mb4 x'41F09F8DA3F09F8DA3' , x'f0', 2)) FROM t1;
SELECT TRIM(BOTH x'f0' FROM _utf8mb4 x'F09F8DA3F09F8DA3');

```
### 2. What did you expect to see? (Required)
```sql

mysql> CREATE TABLE t1(c1 VARCHAR(10));
Query OK, 0 rows affected (0.01 sec)

mysql> INSERT INTO t1 VALUES ('Alaska');
Query OK, 1 row affected (0.00 sec)

mysql> SELECT HEX(LPAD('', 42, REPLACE(COMPRESS(42),c1,''))) FROM t1;
+--------------------------------------------------------------------------------------+
| HEX(LPAD('', 42, REPLACE(COMPRESS(42),c1,'')))                                       |
+--------------------------------------------------------------------------------------+
| 02000000789C33310200009C006702000000789C33310200009C006702000000789C33310200009C0067 |
+--------------------------------------------------------------------------------------+
1 row in set (0.00 sec)

mysql> SELECT HEX(LPAD('', 42, SUBSTRING_INDEX(COMPRESS(42),c1,1))) FROM t1;
+--------------------------------------------------------------------------------------+
| HEX(LPAD('', 42, SUBSTRING_INDEX(COMPRESS(42),c1,1)))                                |
+--------------------------------------------------------------------------------------+
| 02000000789C33310200009C006702000000789C33310200009C006702000000789C33310200009C0067 |
+--------------------------------------------------------------------------------------+
1 row in set (0.00 sec)

mysql> SELECT HEX(LPAD('', 42, TRIM(x'ffff' FROM c1))) FROM t1;
ERROR 3854 (HY000): Cannot convert string '\xFF\xFF' from binary to utf8mb4
mysql> SELECT LPAD('', 42, REPLACE(c1, 'las', x'ff')) FROM t1;
ERROR 3854 (HY000): Cannot convert string '\xFF' from binary to utf8mb4
mysql> SELECT HEX(SUBSTRING_INDEX(_utf8mb4 x'41F09F8DA3F09F8DA3' , x'f0', 2)) FROM t1;
ERROR 3854 (HY000): Cannot convert string '\xF0' from binary to utf8mb4
mysql> SELECT TRIM(BOTH x'f0' FROM _utf8mb4 x'F09F8DA3F09F8DA3');
ERROR 3854 (HY000): Cannot convert string '\xF0' from binary to utf8mb4


```
### 3. What did you see instead (Required)
```sql

mysql> CREATE TABLE t1(c1 VARCHAR(10));
Query OK, 0 rows affected (0.07 sec)

mysql> INSERT INTO t1 VALUES ('Alaska');
Query OK, 1 row affected (0.06 sec)

mysql> SELECT HEX(LPAD('', 42, REPLACE(COMPRESS(42),c1,''))) FROM t1;
+--------------------------------------------------------------------------------------+
| HEX(LPAD('', 42, REPLACE(COMPRESS(42),c1,'')))                                       |
+--------------------------------------------------------------------------------------+
| 02000000789C323102040000FFFF009C006702000000789C323102040000FFFF009C006702000000789C |
+--------------------------------------------------------------------------------------+
1 row in set (0.00 sec)

mysql> SELECT HEX(LPAD('', 42, SUBSTRING_INDEX(COMPRESS(42),c1,1))) FROM t1;
+--------------------------------------------------------------------------------------+
| HEX(LPAD('', 42, SUBSTRING_INDEX(COMPRESS(42),c1,1)))                                |
+--------------------------------------------------------------------------------------+
| 02000000789C323102040000FFFF009C006702000000789C323102040000FFFF009C006702000000789C |
+--------------------------------------------------------------------------------------+
1 row in set (0.00 sec)

mysql> SELECT HEX(LPAD('', 42, TRIM(x'ffff' FROM c1))) FROM t1;
+--------------------------------------------------------------------------------------+
| HEX(LPAD('', 42, TRIM(x'ffff' FROM c1)))                                             |
+--------------------------------------------------------------------------------------+
| 416C61736B61416C61736B61416C61736B61416C61736B61416C61736B61416C61736B61416C61736B61 |
+--------------------------------------------------------------------------------------+
1 row in set (0.01 sec)

mysql> SELECT LPAD('', 42, REPLACE(c1, 'las', x'ff')) FROM t1;
+--------------------------------------------+
| LPAD('', 42, REPLACE(c1, 'las', x'ff'))    |
+--------------------------------------------+
| A?kaA?kaA?kaA?kaA?kaA?kaA?kaA?kaA?kaA?kaA?            |
+--------------------------------------------+
1 row in set (0.00 sec)

mysql> SELECT HEX(SUBSTRING_INDEX(_utf8mb4 x'41F09F8DA3F09F8DA3' , x'f0', 2)) FROM t1;
+-----------------------------------------------------------------+
| HEX(SUBSTRING_INDEX(_utf8mb4 x'41F09F8DA3F09F8DA3' , x'f0', 2)) |
+-----------------------------------------------------------------+
| 41F09F8DA3                                                      |
+-----------------------------------------------------------------+
1 row in set (0.00 sec)

mysql> SELECT TRIM(BOTH x'f0' FROM _utf8mb4 x'F09F8DA3F09F8DA3');
+----------------------------------------------------+
| TRIM(BOTH x'f0' FROM _utf8mb4 x'F09F8DA3F09F8DA3') |
+----------------------------------------------------+
| ???🍣                                                   |
+----------------------------------------------------+
1 row in set (0.00 sec)


```
### 4. What is your TiDB version? (Required)

<!-- Paste the output of SELECT tidb_version() -->
```sql
| Release Version: v5.3.0
Edition: Community
Git Commit Hash: 4a1b2e9fe5b5afb1068c56de47adb07098d768d6
Git Branch: heads/refs/tags/v5.3.0
UTC Build Time: 2021-11-24 13:31:24
GoVersion: go1.16.5
Race Enabled: false
TiKV Min Version: v3.0.0-60965b006877ca7234adaced7890d7b029ed1306
Check Table Before Drop: false |
```
